3 3 3 1 0 0 0
3 3 3 2 2 0 0
4 4 4 2 4 4 4
3 3 3 2 2 1 0
3 3 3 0 1 0 0